11111111111111111111
10000CCCC00000000001
10000CCCC00000000E01
10000000000000000001
10000000000000000001
10000000000000000001
10000000000000000P01
11111111111111111111
